#####################
#s  #   # #         #
### ### # ##### #####
#   # #     #   # # #
# # # ### # # # # # #
# # #     # # #     #
### # # ### ### ### #
#   # #   #     #   #
# # # # ####### ### #
# #   # #         #e#
#####################